WWWWWWWWWWWWWWWWWWWWWWWWWWWWWW
W----------------------------W
W--E-------------------WWWWWWW
WWWWW------------------------W
W----------WWWWWW------------W
W----------W--C--------------WWWWWWWWWWWW
W----------W--C------------C------------W
W-C--------WWWWWWWWWWWWWWWWWWWWWWWWWWWWWW
WWWWWW----------------------------------W
W----------------------------WWWWWWWW---W
W-------------------C-------------------W
WWWWWWW--------WWWWWWWW-----------C-----W
W----------------------------W----------W
W-P-------WWWW--------WWWWWWWWWWWWWWWWWWW
WWWWWWWWWWWWWWWWWWWWWWWWWWWWWWWWWWWWWWWWW