WWWWWWWWWWWWWWWWWWWWWWWWWWWWWW
W----------------------------W
W--C-----------------------E-W
W-------------S----C--WWWWWWWW
W-S--------WWWWWWWWWWWWWWWWWWW
WWWWWW-----------------------W
W--------------WWW-----------W
W-------------------------C--W
W-P-------S------C----WWWWWWWW
WWWWWWWWWWWWWWWWWWWWWWWWWWWWWW