WWWWWWWWWWWWWWWWWWWWWWW
W---------------------W
W-------------------E-W
W----------WWWWWWWWWWWW
WWWWWW----------------W
W---------------------W
W------------------P--W
WWWWWWWWWWWWWWWWWWWWWWW