WWWWWWWWWWWWWWWWWWWWWWWWWWWWWWWWWWWWWWWWWWWWWWW
W---------------------------------------------W
W---------------------------------------------W
W--------------------WWWWWWWWW---S---------E--W
W-S-----------S--------------WWWWWWW----------W
WWWWWW---WWWWWWWWWWWW--------W-CCC-WWWWWWWWWWWW
-----W--------------------------------WWWWWWWWW
-----W---------------------------C------------W
-----W------------------WWWWWWW-------C-------W
WWWWWW-------SS--------------WWWWWW-S----C----W
W----------WWWWWW------------WWWWWWWWWWWWWWWWWW
W----------W--C--------------WWWWWWWW
W----------W--C----SS------C--------W
W--S-------WWWWWWWWWWWWWWWW---------WWWWWWWWWW
WWWWWW---------------------------------------W
------W----------------------WWWWWWWW-----C--W
------W-------------C------------------------W
WWWWWWW--------WWWWWWWW-----------------WWWWWW
W---------------------W----------------------W
W---P-----WWWW----C--SWWWW---S------------S--W
WWWWWWWWWWWWWWWWWWWWWWWWWWWWWWWWWWWWWWWWWWWWWW