WWWWWWWWWWWWWWWWWWWWWWW
W---------------------W
W------------C------E-W
W----------WWWWWWWWWWWW
WWWWWW----------------W
W---C-----------------W
W------------------P--W
WWWWWWWWWWWWWWWWWWWWWWW