WWWWWWWWWWWWWWWWWWWWWWWWWWWWWWWWWWWWWWWWWWWWWW
W--------------------------------------------W
W--------------------------------------------W
W----WWWWWWWWWWWWWWWWWWWWWWWWWWWWWWWWWWWW----W
W----W----------------------------------W----W
W----W----------------------------------W----W
W----W----WWWWWWWWWWWWWWWWWWWWWWWWWW----W----W
W----W----W------------------------W----W----W
W----W----W------------------------W----W----W
W----W----W----WWWWWWWWWWWWWWWW----W----W----W
W----W----W----W--------------W----W----W----W
W----W----W----W----C------C--W----W----W----W
W----W----W----W--------------W----W----W----W
W----W----W----W-------F------W----W----W----W
W----W----W----W--------------W----W----W----W
W----W----W----W----C-----C---W----W----W----W
W----W----W----W--------------W----W----W----W
W----W----W----W--------------W----W----W----W
W----W----w----W-------------------W----W----W
W----W----W----WWWWWWWWWWWWWWWWWWWWW----W----W
W----W----W-----------------------------W----W
W----W----W-----------------------------W----W
W----W----WWWWWWWWWWWWWWWWWWWWWWWWWWWWWWW----W
W--P-W---------------------------------------W
W----W---------------------------------------W
WWWWWWWWWWWWWWWWWWWWWWWWWWWWWWWWWWWWWWWWWWWWWW