WWWWWWWWWWWWWWWWWWWWWWWWWWWWWW
W----------------------------W
W--------------------------E-W
W-S--------------------WWWWWWW
WWWWW---------S--------------W
W----------WWWWWW------------W
W----------W--C--------------WWWWWWWWWWWW
W----------W--C-------S----C----------S-W
W-C--------WWWWWWWWWWWWWWWWWWWWWWWWWWWWWW
WWWWWW----------------------------------W
W----------------------------WWWWWWWW---W
W--S----------------C-------------------W
WWWWWWW--------WWWWWWWW-----------C-----W
W----------------------------W----------W
W-P-------WWWW----S---WWWWWWWWWWWWWWWWWWW
WWWWWWWWWWWWWWWWWWWWWWWWWWWWWWWWWWWWWWWWW