WWWWWWWWWWWWWWWWWWWWWWWWWWWWWW
W----------------------------W
W--------------------------E-W
W---------------------WWWWWWWW
W----------WWWWWWWWWWWWWWWWWWW
WWWWWW-----------------------W
W--------------WWW-----------W
W----------------------------W
W-P-------------------WWWWWWWW
WWWWWWWWWWWWWWWWWWWWWWWWWWWWWW