WWWWWWWWWWWWWWWWWWWWWWWWWWWWWW
W----------------------------W
W--C-----------------------E-W
W------------------C--WWWWWWWW
W----------WWWWWWWWWWWWWWWWWWW
WWWWWW-----------------------W
W--------------WWW-----------W
W-------------------------C--W
W-P--------------C----WWWWWWWW
WWWWWWWWWWWWWWWWWWWWWWWWWWWWWW